0 0 0 0 0 0 0 0 0 0 0 0 0 0 0 0 0 0 0 0 0 0 0 0
0 0 7 0 7 0 0 0 0 0 0 0 0 0 0 0 0 0 0 0 0 3 0 0
0 0 0 7 0 0 0 0 1 1 1 1 1 0 0 0 0 0 0 0 0 0 0 0 
0 0 8 0 0 0 0 0 1 0 0 0 1 0 0 0 0 0 0 0 0 0 0 0
0 0 3 0 0 0 0 0 1 0 3 0 1 1 1 1 1 1 0 0 0 0 0 0
5 1 1 1 1 1 0 0 1 0 0 0 0 0 0 0 0 1 0 0 0 3 0 0
0 0 0 0 0 1 0 3 1 0 11 0 0 11 0 3 0 1 0 0 0 0 1 4
0 0 0 0 0 1 0 0 1 0 0 0 0 0 0 0 0 1 0 0 0 0 1 0
0 0 0 0 0 1 3 0 1 0 0 0 3 0 0 0 0 1 3 0 0 3 1 0
0 0 0 0 0 1 1 1 1 0 0 0 0 0 0 0 0 1 1 1 1 1 1 0
0 0 0 0 0 0 0 0 0 0 0 0 0 0 0 0 0 0 0 0 0 0 0 0
0 0 0 0 0 0 0 0 0 0 0 0 0 0 0 0 0 0 0 0 0 0 0 0